  1  2  2  2  2  2  2  2  2  2  2  2  2  2  2  2  2  2  2  2  2  2  2  2  2  2  2  2  2  3
  1  2  2  2  2  2  2  2  9  0  0  0  0  2  9  0  0  0  0  2  2  2  2  2  2  2  2  2  2  3
 10  3  0  0  0  0  0  0  0  0  0  0  0  0  6  0  0  0  0  0  0  0  0  0  0  0  0  0  1  3
  1  3  0  0  0  0  0  0  0  0  0  0  0  0  6  0  0  0  0  0  0  0  0  0  0  0  0  0  1  3
  1  3  0  0  0  0  0  0  0  0  0  0  0  0  6  0  0  0  0  0  0  0  0  0  0  0  0  0  1  3
  1  3  0  0  0  0  0  0  0  0  0  0  0  0  6  0  0  0  0  0  0  0  0  0  0  0  0  0  1  3
  1  3  2  2  7  2  2  2  2  2  2  2  2  2  2  2  2  2  2  2  2  2  2  2  2  7  2  2  1  3
 10  3  0  0  0  0  0  0  0  0  0  0  0  0  6  0  0  0  0  0  0  0  0  0  0  0  0  0  1  3
  1  3  0  0  0  0  0  0  0  0  0  0  0  0  6  0  0  0  0  0  0  0  0  0  0  0  0  0  1  3
  1  3  0  0  0  0  0  0  0  0  0  0  0  0  6  0  0  0  0  0  0  0  0  0  0  0  0  0  1  3
  1  3  2  2  2  2  2  2  3  0  0  0  0  0  6  0  0  0  0  0  1  2  2  2  2  2  2  2  1  3
 10  3  0  0  0  0  0  0  0  0  0  0  0  0  6  0  0  0  0  0  0  0  0  0  0  0  0  0  1  3
  1  3  0  0  0  0  0  0  0  0  0  1  2  2  2  2  2  3  0  0  0  0  0  0  0  0  0  0  1  3
  1  3  0  0  0  0  0  0  0  0  0  0  0  0  0  0  0  2  0  0  0  0  0  0  0  0  0  0  1  3
  1  3  0  0  0  0  0  0  0  0  0  0  0  0  0  0  0  2  0  0  0  0  0  0  0  0  0  0  1  3
  1  2  2  2  8  2  2  2  8  2  2  2  8  2  2  2  8  2  2  2  8  2  2  8  2  2  8  2  2  3
  1  2  2  2  2  2  2  2  2  2  2  2  2  2  2  2  2  2  2  2  2  2  2  2  2  2  2  2  2  3
