  1  2  2  2  2  2  2  2  2  2  2  2  2  2  2  2  2  2  2  2  3  6  1  3  9  9  9  9  1  3
  1  2  2  2  2  2  2  2  2  2  2  2  2  2  2  2  2  2  2  2  3  0  1  3  0  0  0  0  1  3
  1  3  0  0  0  0  0  0  0  0  0  0  0  0  0  0  0  0  0  0  0  0  0  0  0  0  0  0  1  3
  1  3  0  0  0  0  0  0  0  0  0  0  0  0  0  0  0  0  0  0  0  0  0  0  0  0  0  0  1  3
  1  3  0  0  0  0  0  0  0  0  0  0  0  0  0  0  0  0  0  0  0  0  0  0  0  0  0  0  1  3
  1  3  0  0  0  0  0  0  0  0  0  0  0  0  0  0  0  0  0  0  0  0  0  0  0  0  0  0  1  3
  1  3  2  2  2  2  2  7  2  2  2  2  2  7  2  2  2  2  2  7  2  2  2  2  3  0  0  0  1  3
  1  3  0  0  2  0  0  0  0  0  2  0  0  0  0  0  2  0  0  0  0  0  2  0  0  0  0  0  1  3
  1  3  0  0  0  0  0  0  0  0  0  0  0  0  0  0  0  0  0  0  0  0  0  0  0  0  0  0  1  3
  1  3  0  0  0  0  0  0  0  0  0  0  0  0  0  0  0  0  0  0  0  0  0  0  0  0  0  0  1  3
  1  3  0  0  7  0  0  0  0  0  7  0  0  0  0  0  7  0  0  0  0  0  7  0  0  0  0  0  1  3
  1  3  0  2  0  2  0  0  0  2  0  2  0  0  0  2  0  2  0  0  0  2  0  2  0  0  0  0  1  3
  1  2  3  0  0  0  1  0  3  0  0  0  1  0  3  0  0  0  1  0  3  0  0  0  1  0  3  0  1  3
  1  2  3  0  0  0  1  2  3  0  0  0  1  2  3  0  0  0  1  2  3  0  0  0  1  2  3  0  1  3
  1  3  0  0  0  0  0  0  0  0  0  0  0  0  0  0  0  0  0  0  0  0  0  0  0  0  0  0  1  3
  1  3  0  0  0  0  0  0  0  0  0  0  0  0  0  0  0  0  0  0  0  0  0  0  0  0  0  0  1  3
  1  2  2  8  2  8  2  8  2  8  2  8  2  8  2  8  2  8  2  8  2  8  2  8  2  8  2  2  2  3
