  1  2  2  2  2  2  2  2  2  2  2  2  2  2  2  2  2  2  2  2  2  2  6  2  3  9  9  9  9  3
  1  2  2  2  2  2  2  2  2  2  2  2  2  2  2  2  2  2  2  2  2  2  0  2  3  0  0  0  0  3
  1  0  0  0  0  0  0  0  0  0  0  0  0  0  0  0  0  0  0  0  0  0  0  0  0  0  0  0  0  3
  1  0  0  0  0  0  0  0  0  0  0  0  0  0  0  0  0  0  0  0  0  0  0  0  0  0  0  0  0  3
  1  0  2  2  2  2  2  7  2  2  2  2  2  7  2  2  2  2  2  7  2  2  2  2  2  0  0  0  0  3
  1  0  0  0  2  0  0  0  0  0  2  0  0  0  0  0  2  0  0  0  0  0  2  0  0  0  0  0  0  3
  1  0  0  0  0  0  0  0  0  0  0  0  0  0  0  0  0  0  0  0  0  0  0  0  0  0  0  0  0  3
  1  0  0  0  0  0  0  0  0  0  0  0  0  0  0  0  0  0  0  0  0  0  0  0  0  0  0  0  0  3
  1  0  0  0  7  0  0  0  0  0  7  0  0  0  0  0  7  0  0  0  0  0  7  0  0  0  0  0  0  3
  1  0  0  2  0  2  0  0  0  2  0  2  0  0  0  2  0  2  0  0  0  2  0  2  0  0  0  2  0  3
  1  0  2  0  0  0  2  0  2  0  0  0  2  0  2  0  0  0  2  0  2  0  0  0  2  0  2  0  0  3
  1  2  2  0  0  0  2  2  2  0  0  0  2  2  2  0  0  0  2  2  2  0  0  0  2  2  2  0  0  2
  1  0  0  0  0  0  0  0  0  0  0  0  0  0  0  0  0  0  0  0  0  0  0  0  0  0  0  0  0  3
  1  0  0  0  0  0  0  0  0  0  0  0  0  0  0  0  0  0  0  0  0  0  0  0  0  0  0  0  0  3
  1  0  0  0  0  0  0  0  0  0  0  0  0  0  0  0  0  0  0  0  0  0  0  0  0  0  0  0  0  3
  1  0  0  0  0  0  0  0  0  0  0  0  0  0  0  0  0  0  0  0  0  0  0  0  0  0  0  0  0  3
  1  8  2  8  2  8  2  8  2  8  2  8  2  8  2  8  2  8  2  8  2  8  2  8  2  8  2  8  2  3
